11111111111111111111
10000000001111000001
10000200001111000001
10000000001111000001
10000000000000000001
10000000000000000001
10001110001111000001
10001110001111000001
10001110000000000001
10001110001111000001
10001110001111000001
10001110001111000001
10001110001111000001
10000000001111000001
10000000001111000001
10000000000000000001
10000000001111000001
10000000001111000001
10000000001111000001
11111111111111111111

