111111111111111111111
100000000011110000111
10000C000011110000011
100000000011110000011
10000000P000000000011
100000000000000000011
100011100011110000011
100011100011110000011
100011100000000000011
100011100011110000011
100011100011110000011
100011100011110000011
100011100011110000011
100000000011110000011
100000000011110000011
100000000000000000011
100C00000011110000011
100000000011110000011
100000000011110000E11
111111111101111111111
111111111111111111111
